1111111111
10000P0001
1E00000001
100C000001
1111111111