111111111111111
100000P00111111
1E00000C0111111
100C00C00111111
111111111111111