11111111111111111111111111111
1000E00000000000000000000C001
11111111111100001111111111111
100C000000010000100000C000001
10111111111100001111111111101
10100000000C00000000000000101
10111111111100001111111111101
10000010000000000000001000001
10111110000000000000001111101
10100000000000000000000000101
10100000000P00000000000000101
10100000000000000000000000101
10111111000000000000011111101
10000000000000000000000000001
10000000000000000000000000001
11111111111111111111111111111