11111111111111111111111111111
100000000000C00000000000000E1
10111111111111111111111111111
10000000000000000000000000001
10111111111111111111111111101
100000000000000000000C0000001
10111111111111111111111111101
10000000000000000000000000001
11111111111111111111111111101
100000000C0000000000000000001
10100000000P00000000000000101
10111111111111011111111111101
10111111000000000000011111101
100000010000C0000000000000001
10000000000000000000000000001
11111111111111111111111111111