11111111111111111111111111111
100C100010000000000000100C101
10101010100000000000001010101
10101010100000000000001010101
10101010100000000000001010101
10101010100000000000001010101
10101010100000000000001010101
101010101000000000000010101C1
10101C101000000C0000001010101
10101010100000000000001010101
10101010100P00000000001010101
10101010100000000000001010101
10101010100000000000001C10101
10101010100000000000001010101
101000100000000E0000000010001
11111111111111111111111111111