11111111111111111111111111111
100000000000C0000000000000001
10111000010000000111100000001
100010000100000010000100E0001
10111000010000000000101111101
10001000010000000111000000001
10111111111111111111111111111
100000000100C0000000000000001
11110000011111111111111111101
100000000000000000000C0000001
10100000000P00000000000000001
10111111111111011111111111111
101111110000C0000000011111111
10000001000000000000010000001
10000000000000000000000000001
11111111111111111111111111111